00000000000000000000000000
00000000000000000000000000
00110011001100110011001100
00110011001100110011001100
00110011001100110011001100
00110011001144110011001100
00110011001144110011001100
00110011001100110011001100
00110011000000000011001100
00110011000000000011001100
00000000001100110000000000
00000000001100110000000000
11001111000000000011110011
44001111000000000011110044
00000000001100110000000000
00000000001111110000000000
00110011001111110011001100
00110011001100110011001100
00110011001100110011001100
00110011001100110011001100
00110011001100110011001100
00110011000000000011001100
00110011000000000011001100
00110011000111100011001100
00000000000160100000000000
00000000000100100000000000
