00000044000000440000000000
00000044000000440000000000
00110044000000110011001100
00110044000000110011001100
00110000000011110011441100
00110000000011110011441100
00000000000000000044000000
00000000000000000044000000
55000000000044000011551144
55000000000044000011551144
55550000001100000000550000
55550000001100000000550000
00111111555555440000551100
00111111555555440000551100
00000044551100110011001100
00000044551100110011001100
44110044001100110000001100
44110044001100110000001100
00110011001111110011441100
00110011001111110011441100
00110011001111110000000000
00110011001111110000000000
00000000000000000011001100
00000000000111100011001100
01100011000160100011111100
01100011000100100011111100
